1111111111111111111
1000000000C00000001
1C00E00P00C00011001
1C00111001C10000001
1C00010001C10000001
1110100001110C01001
1C00000100C00C01001
1C11000000C00C01001
1C00011000C00C01001
1C00000100C00C01001
1111111111111111111
